# Special countries..
REB = "countries/Rebels.txt"

#Update 0.1
CRF = "countries/Corfu2.txt"
ACY = "countries/Ancyra.txt"
AEL = "countries/Aelis.txt"
AKR = "countries/Akroinon.txt"
AME = "countries/Amaseia.txt"
ATL = "countries/Attaleia.txt"
CAP = "countries/Kappadokia.txt"
CIO = "countries/Chios.txt"
CPH = "countries/Cephalonia.txt"
DOR = "countries/Dorylaeum.txt"
EOD = "countries/Eudoxia.txt"
EUB = "countries/Euboea.txt"
GAN = "countries/Gangara.txt"
HIE = "countries/Hierapolis.txt"
ION = "countries/Ionnia.txt"
JUS = "countries/Justinianpolis.txt"
KOO = "countries/Koloneia.txt"
KRS = "countries/Kerasounta.txt"
KST = "countries/Kastoria.txt"
LES = "countries/Lesbos.txt"
LRD = "countries/Laranda.txt"
MGN = "countries/Magnesia.txt"
MOB = "countries/Mobolla.txt"
PLA = "countries/Pelagonia.txt"
RHO = "countries/Rhodes.txt"
SAP = "countries/Sampsounta.txt"
SIN = "countries/Sinope.txt"
SMY = "countries/Smyrna.txt"
SRE = "countries/Serres.txt"
THE = "countries/Thessaly.txt"
TMN = "countries/Timonion.txt"
TPZ = "countries/Trapezus.txt"
TRL = "countries/Tralles.txt"
ICO = "countries/Iconium.txt"
CER = "countries/Cerasus.txt"
KAI = "countries/Kaisareia.txt"
EKL = "countries/Ekleipsopolis.txt"
SIV = "countries/Sevasteia.txt"
HON = "countries/Honorias.txt"
PLY = "countries/Polydorion.txt"
COT = "countries/Cotyaeum.txt"

PEL = "countries/Peleponnesia.txt"
MAC = "countries/Makedonia.txt"
KOA = "countries/Anatolia.txt"
PON = "countries/Pontus.txt"
HLL = "countries/Hellenia.txt"
MES = "countries/Mesissia.txt"
MGS = "countries/Mesogeakia.txt"
MEA = "countries/MegaliAnatolia.txt"
TRK = "countries/Thrakia.txt"
NIS = "countries/Nisia.txt"
MIP = "countries/Miapatrida.txt"

#Update 0.2
CIL = "countries/Cilicia.txt"

#Update 0.3
ILY = "countries/Illyria.txt"
PAO = "countries/Pannonia.txt"
IST = "countries/Istrosia.txt"
SLT = "countries/Silistra.txt"
DLM = "countries/Dalmatia2.txt"
FLU = "countries/Flumen.txt"
MEO = "countries/Moesia.txt"

#Update 0.4
OLT = "countries/Oltenia.txt"
VLH = "countries/Valahia.txt"
BOG = "countries/Bogdania.txt"
BNT = "countries/Banat.txt"
AKD = "countries/Aksidava.txt"
ALD = "countries/Albodava.txt"
BTB = "countries/Butabaur.txt"

DAC = "countries/Dacia.txt"
GEA = "countries/Getae.txt"


#Update 0.5
SVE = "countries/Svelland.txt"
HJR = "countries/Hjorreyland.txt"
VTE = "countries/Vitteborg.txt"
KO1 = "countries/Mannborg.txt"
KEW = "countries/Kernowia.txt"
CYU = "countries/Cyumria.txt"
CUM = "countries/Cumbria.txt"
DOW = "countries/Downfund.txt"
ILO = "countries/Iloirland.txt"
GWT = "countries/Gwintland.txt"
GAY = "countries/Gaelsith.txt"
EIG = "countries/Eightirland.txt"

GOI = "countries/Goidelia.txt"
PCT = "countries/Pictland.txt"
ABO = "countries/Albion.txt"
BET = "countries/Bretland.txt"
BRO = "countries/Brittonia.txt"
UCE = "countries/UnitedCeltia.txt"

#Update 0.6
ATU = "countries/Asturesia.txt"
ULA = "countries/Ulsatajo.txt"
GLL = "countries/Gallecia.txt"
BRD = "countries/Berdeny.txt"
SLP = "countries/Silapuria.txt"
FND = "countries/Findunia.txt"
VLE = "countries/Valentia.txt"
IBO = "countries/Ibossia.txt"
BSQ = "countries/Basque.txt"
BAE = "countries/Baetisy.txt"

IBE = "countries/Iberia.txt"
IBC = "countries/CeltIberia.txt"
LUS = "countries/Lusitania.txt"

#Update 0.7
ALN = "countries/AlbengaNizza.txt"
MLT = "countries/Malta.txt"
ANC = "countries/Anconna.txt"
RMG = "countries/Romagna.txt"
SZZ = "countries/Saluzzo.txt"
FIR = "countries/Firenze.txt"
BRM = "countries/Bergamo.txt"
VRB = "countries/Verbano.txt"
TRO = "countries/Trento.txt"
CMB = "countries/Campobossa.txt"
CLT = "countries/Calatabia.txt"
AUP = "countries/Apulia.txt"
TRN = "countries/Torino.txt"
CPM = "countries/Campania.txt"
ARZ = "countries/Arezzo.txt"

#update 0.8
ERA = "countries/Eramosia.txt"
RIT = "countries/Ritmoria.txt"
VNT = "countries/Vennetia.txt"
BEY = "countries/Beneyra.txt"
VRL = "countries/Verland.txt"
MRD = "countries/Marundy.txt"
CLE = "countries/Caletis.txt"
BLF = "countries/BelgicaFlemia.txt"
PVS = "countries/Parvusdunum.txt"
UDC = "countries/UpperDecumatia.txt"
LDC = "countries/LowerDecumatia.txt"
SEQ = "countries/Sequan.txt"
VOC = "countries/Vocontia.txt"
CTG = "countries/Caterugia.txt"
ALP = "countries/Alpantian.txt"
MSS = "countries/Massilia.txt"
ALI = "countries/Arelation.txt"
GZT = "countries/Gaztellia.txt"
CIP = "countries/Cipucert.txt"
MTB = "countries/Maturbs.txt"
VIN = "countries/Vindastu.txt"
CMN = "countries/Comenia.txt"
UXE = "countries/Uxelloland.txt"
TRV = "countries/Tarvosager.txt"
UNO = "countries/Unomia.txt"
SNO = "countries/Senoturrim.txt"
PTR = "countries/Petricollia.txt"
EPR = "countries/Eportia.txt"
DBX = "countries/Dubiarx.txt"
RGK = "countries/Regmarkia.txt"
OAE = "countries/Odacosia.txt"
CSY = "countries/Casiany.txt"
OSX = "countries/Ostruxia.txt"
BGC = "countries/Belgica.txt"
FLE = "countries/Flemia.txt"
GL2 = "countries/Gallia.txt"
DCC = "countries/Decumatia.txt"
HLV = "countries/Helvetia.txt"